...............................................................................
.                                                                             .
.                                      ..........         .................  ..
.            ..                                 .                          .  .
.             ..                                .                          .  .
.              ..                               .                          .  .
.               ............                    .                          .  .
.                ..                             .                          .  .
.                 ..                            .                          .  .
.                  ..                           .                          .  .
.                                               .                          .  .
.                                               .                          .  .
.                        ........................         ..................  .
...                                             .         .                   .
.    .                   ..............         .         ..                  .
......                   .            .         .          .                  .
.p                       .                      .           .                 .
.                        .            .         .            .                .
.                        ......... ....         .             .               .
.    ...                        .  . ............              .              .
.    .                          .  . .                          .             .
.    ..                         .  .   ..........          ......             .
.     ..       ...........      .     .        .............                  .
.      .     ...     ..          .......   ......                             .
........       ...    ...........................                             .
.                                                                             .
...............................................................................
